12 20
####################
#               # .#
#               #  #
#   B   #####      #
##          #      #
#     #######      #
##          #      #
#   B######## B    #
#@        #        #
##########         #
#.                .#
####################